Москва	РФ
США	Вашингтон
РФ	Россия
ЕС	Европа
ЕС	Евросоюз
Евросоюз	Европа
США	Соедниненные Штаты Америки
Соединенный штат	США
Амстердам	Нидерланды
Андорра-ла-Велья	Андорра
Афины	Греция
Белград	Сербия
Берлин	Германия
Берн	Швейцария
Братислава	Словакия
Брюссель	Бельгия
Будапешт	Венгрия
Бухарест	Румыния
Вадуц	Лихтенштейн
Валлетта	Мальта
Варшава	Польша
Ватикан	Ватикан
Вена	Австрия
Вильнюс	Литва
Дублин	Ирландия
Загреб	Хорватия
Киев	Украина
Кишинёв	Молдавия
Кишинев	Молдавия
Копенгаген	Дания
Лиссабон	Португалия
Лондон	Великобритания
Любляна	Словения
Люксембург	Люксембург
Мадрид	Испания
Минск	Белоруссия
Монако	Монако
Москва	Россия
Осло	Норвегия
Париж	Франция
Подгорица	Черногория
Прага	Чехия
Рейкьявик	Исландия
Рига	Латвия
Рим	Италия
Сан-Марино	Сан-Марино
Сараево	Босния и Герцеговина
Скопье	Республика Македония
София	Болгария
Стокгольм	Швеция
Таллин	Эстония
Тирана	Албания
Хельсинки	Финляндия
Абу-Даби	Объединённые Арабские Эмираты
Амман	Иордания
Анкара	Турция
Астана	Казахстан
Ашхабад	Туркмения
Багдад	Ирак
Баку	Азербайджан
Бангкок	Таиланд
Бандар-Сери-Бегаван	Бруней
Бейрут	Ливан
Бишкек	Киргизия
Вьентьян	Лаос
Дакка	Бангладеш
Дамаск	Сирия
Джакарта	Индонезия
Дили	Восточный Тимор
Доха	Катар
Душанбе	Таджикистан
Ереван	Армения
Иерусалим	Израиль
Исламабад	Пакистан
Кабул	Афганистан
Катманду	Непал
Куала-Лумпур	Малайзия
Мале	Мальдивы
Манама	Бахрейн
Манила	Филиппины
Маскат	Оман
Нейпьидо	Мьянма
Никосия	Республика Кипр
Пекин	Китайская Народная Республика
Пномпень	Камбоджа
Пхеньян	Корейская Народно-Демократическая Республика
Сана	Йемен
Сеул	Республика Корея
Сингапур	Сингапур
Ташкент	Узбекистан
Тбилиси	Грузия
Тегеран	Иран
Токио	Япония
Тхимпху	Бутан
Улан-Батор	Монголия
Ханой	Вьетнам
Шри-Джаяварденепура-Котте	Шри-Ланка
Эль-Кувейт	Кувейт
Эр-Рияд	Саудовская Аравия
Абуджа	Нигерия
Аддис-Абеба	Эфиопия
Аккра	Гана
Алжир	Алжир
Антананариву	Мадагаскар
Асмэра	Эритрея
Бамако	Мали
Банги	Центральноафриканская Республика
Банжул	Гамбия
Бисау	Гвинея-Бисау
Браззавиль	Республика Конго
Бужумбура	Бурунди
Виктория	Сейшельские Острова
Виндхук	Намибия
Габороне	Ботсвана
Дакар	Сенегал
Джибути	Джибути
Джуба	Южный Судан
Додома	Танзания
Каир	Египет
Кампала	Уганда
Кигали	Руанда
Киншаса	Демократическая Республика Конго
Конакри	Гвинея
Либревиль	Габон
Лилонгве	Малави
Ломе	Того
Луанда	Ангола
Лусака	Замбия
Малабо	Экваториальная Гвинея
Мапуту	Мозамбик
Масеру	Лесото
Мбабане	Свазиленд
Могадишо	Сомали
Монровия	Либерия
Морони	Коморы
Найроби	Кения
Нджамена	Чад
Ниамей	Нигер
Нуакшот	Мавритания
Порт-Луи	Маврикий
Порто-Ново	Бенин
Прая	Кабо-Верде
Претория	Южно-Африканская Республика
Рабат	Марокко
Сан-Томе	Сан-Томе и Принсипи
Триполи	Флаг Ливии
Тунис	Тунис
Уагадугу	Буркина-Фасо
Фритаун	Сьерра-Леоне
Хараре	Зимбабве
Хартум	Судан
Ямусукро	Кот-д’Ивуар
Яунде	Камерун
Асунсьон	Парагвай
Бастер	Сент-Китс и Невис
Бельмопан	Белиз
Богота	Колумбия
Бразилиа	Бразилия
Бриджтаун	Барбадос
Буэнос-Айрес	Аргентина
Вашингтон	Соединённые Штаты Америки
Гавана	Куба
Гватемала	Гватемала
Джорджтаун	Гайана
Каракас	Венесуэла
Кастри	Сент-Люсия
Кингстаун	Сент-Винсент и Гренадины
Кингстон	Ямайка
Кито	Эквадор
Лима	Перу
Манагуа	Никарагуа
Мехико	Мексика
Монтевидео	Уругвай
Нассау	Багамские Острова
Оттава	Канада
Панама	Панама
Парамарибо	Суринам
Порт-о-Пренс	Республика Гаити
Порт-оф-Спейн	Тринидад и Тобаго
Розо	Доминика
Сан-Сальвадор	Сальвадор
Сан-Хосе	Коста-Рика
Санто-Доминго	Доминиканская Республика
Сантьяго	Чили
Сент-Джонс	Антигуа и Барбуда
Сент-Джорджес	Гренада
Сукре	Боливия
Тегусигальпа	Гондурас
Апиа	Самоа
Веллингтон	Новая Зеландия
Канберра	Австралия
Маджуро	Маршалловы Острова
Нгерулмуд	Палау
Нукуалофа	Тонга
Паликир	Федеративные Штаты Микронезии
Порт-Вила	Вануату
Порт-Морсби	Папуа — Новая Гвинея
Сува	Фиджи
Фунафути	Тувалу
Хониара	Соломоновы Острова
Южная Тарава	Кирибати
Науру	Науру
